Rk,Squad,MP,W,D,L,GF,GA,GD,Pts
1,Manchester Utd,38,28,5,5,83,27,56,89
2,Chelsea,38,24,11,3,64,24,40,83
3,Liverpool,38,20,8,10,57,27,30,68
4,Arsenal,38,19,11,8,63,35,28,68
5,Tottenham,38,17,9,12,57,54,3,60
6,Everton,38,15,13,10,52,36,16,58
7,Bolton,38,16,8,14,47,52,-5,56
8,Reading,38,16,7,15,52,47,5,55
9,Portsmouth,38,14,12,12,45,42,3,54
10,Blackburn,38,15,7,16,52,54,-2,52
11,Aston Villa,38,11,17,10,43,41,2,50
12,Middlesbrough,38,12,10,16,44,49,-5,46
13,Newcastle Utd,38,11,10,17,38,47,-9,43
14,Manchester City,38,11,9,18,29,44,-15,42
15,West Ham,38,12,5,21,35,59,-24,41
16,Fulham,38,8,15,15,38,60,-22,39
17,Wigan Athletic,38,10,8,20,37,59,-22,38
18,Sheffield Utd,38,10,8,20,32,55,-23,38
19,Charlton Ath,38,8,10,20,34,60,-26,34
20,Watford,38,5,13,20,29,59,-30,28
