Rk,Squad,MP,W,D,L,GF,GA,GD,Pts
1,Blackburn,42,27,8,7,80,39,41,89
2,Manchester Utd,42,26,10,6,77,29,48,88
3,Nott'ham Forest,42,22,11,9,72,43,29,77
4,Liverpool,42,21,11,10,65,37,28,74
5,Leeds United,42,20,13,9,59,38,21,73
6,Newcastle Utd,42,20,12,10,67,47,20,72
7,Tottenham,42,16,14,12,66,58,8,62
8,QPR,42,17,9,16,61,59,2,60
9,Wimbledon,42,15,11,16,48,65,-17,56
10,Southampton,42,12,18,12,61,63,-2,54
11,Chelsea,42,13,15,14,50,55,-5,54
12,Arsenal,42,13,12,17,53,49,4,51
13,Sheffield Weds,42,13,12,17,49,57,-8,51
14,West Ham,42,13,11,18,44,48,-4,50
15,Everton,42,11,17,14,44,51,-7,50
16,Coventry City,42,12,14,16,44,62,-18,50
17,Manchester City,42,12,13,17,53,64,-11,49
18,Aston Villa,42,11,15,16,51,56,-5,48
19,Crystal Palace,42,11,12,19,34,49,-15,45
20,Norwich City,42,10,13,19,37,54,-17,43
21,Leicester City,42,6,11,25,45,80,-35,29
22,Ipswich Town,42,7,6,29,36,93,-57,27
